xxxxxxxxxxxxxxxxxxxxxxxxxxxxxxx
!         !      o      x     x
!         !                   x
!                             x
!              x        x     x
!          x   x    x   x  o  x
xxx!!!xxxxxxxxxx!!!xxxx!xx!x!xx
