xxxxxxxxxxxxxxxxxxxxxx
x                    x
x                    x
x   p                x
x          o         x
x                 o  x
xxxxxxx!!xxxxx!!xxxxxx