x!!!!!!!!!!!!!!!!!!!!!!!!!!!!!!!!!!!!x
x                                    x
x                                    x
x  o          o   p   o           o  x
x                                    x
x     x #    #x       x #     #x     x
x!!!!!xxxxxxxxxxxx!xxxxxxxxxxxxx!!!!!x