xxxxxxxxxxxxxxxxxxxxxx
x                    x
x                    x
x  p     o           x
x                    x
x       xxx       o  x
xxxxxxxxxxxxxxxxxxxxxx