xxxxxxxxxxxxxxxxxxxxxx
!         !          x
!                 o  x
!         o          x
!                    x
!     o   !  # x     x
xxxxxxxxxxxxxxxx!!!!!x
