xxxxxxxxxxxxxxxxxxxxxxxxxxx
!                    p    x
!    xxx x  x xx   xx     x
!    x   x  x x x    x    x
! !  xxx xx x x x   x     x
! o  x   x xx x x         x
!    xxx x  x xx    x     x
!    -                    x
xxxxxxxxxxxxxxxxx!!xxx!!!!x