xxxxxxx!!!xxxxxxxxxxxxxxxxxxxxxxxx!x
x            o                    !x
x                                 !x
x    o  x #   # x   o    o         x
x       xxxxxxxxxxxxxx!!xxxxxxx    x
x  o            p                 xx
x                               x  x
x       x  # #        #  #   x     x
x!!!!!xxxxxxxxxxxxxxxxxxxxxxxx!!!!!x