xxxxxxxxxxxxxxxxxxxxxxxxxxxxxxxxxx
!         !      o      x        x
!         !                      x
!                                x
!              x        x        x
!          x   x    x   x  o     x
!       x  x        x            x
x   xxxxx  xxxxx!!!xxxx!xx!x!xxxxx
xx     o     #      o    #       x
xxxxxxxxxxxxxxxxxxxxxxxxxxxxxxxxxx