xxxxxxxxxxxxxxxxxxxxxxxxxxxxxxxxxxxxxx
x                                    x
x                                    x
x  o              p               o  x
x                                    x
x     x #     x       x       #x     x
x!!!!!xxxxxxxxxxxxxxxxxxxxxxxxxx!!!!!x