xxxxxxxxxxxxxxxxxxxxxx
!                    x
!                    x
!                 o  x
! p                  x
!     x    #   x     x
xxxx!!xxxxxxxxxx!!!!!x